0,9,1,9,9,1,9,9,1,2,
3,2,10,10,0,7,1,2,10,10,
10,10,10,6,4,8,6,4,4,5,
10,3,4,9,8,9,9,5,6,10,
10,6,5,3,9,9,1,5,10,10,
10,0,4,7,1,5,10,3,8,10,
3,2,3,1,4,2,10,6,2,10,
10,10,10,10,3,8,3,9,4,5,
10,10,0,8,6,2,7,9,7,10,
6,9,7,9,9,7,9,9,9,8,

